Benchmark,CPU0 Cycles,CPU0 IPC,CPU0 Instructions,CPU0 LLC Hit,CPU0 LLC Miss,CPU0 LLC Total Access,CPU1 Cycles,CPU1 IPC,CPU1 Instructions,CPU1 LLC Hit,CPU1 LLC Miss,CPU1 LLC Total Access,CPU2 Cycles,CPU2 IPC,CPU2 Instructions,CPU2 LLC Hit,CPU2 LLC Miss,CPU2 LLC Total Access,CPU3 Cycles,CPU3 IPC,CPU3 Instructions,CPU3 LLC Hit,CPU3 LLC Miss,CPU3 LLC Total Access,LLC Blocked Read,LLC Blocked Write,LLC Freed,LLC Invincible Activated,Simulation Time
605.mcf_s-665B.champsimtrace_607.cactuBSSN_s-2421B.champsimtrace_619.lbm_s-4268B.champsimtrace_625.x264_s-18B.champsimtrace.txt,2980491231,0.0671,200000003,1115025,3394707,4509732,532998734,0.3752,200000001,977064,1639781,2616845,1464927574,0.1365,200000000,7126325,9687746,16814071,239752310,0.8342,200000003,136097,321219,457316,2117233,285489,2777828,4693505,15 hr 53 min 33 sec
605.mcf_s-665B.champsimtrace_619.lbm_s-4268B.champsimtrace_625.x264_s-18B.champsimtrace_648.exchange2_s-1699B.champsimtrace.txt,1862750241,0.1074,200000000,2060528,2374934,4435462,1053441504,0.1899,200000001,7132425,9656974,16789399,165800423,1.206,200000000,164045,283060,447105,136065551,1.47,200000001,0,8835,8835,1022935,210184,1747579,2936947,21 hr 49 min 49 sec
605.mcf_s-665B.champsimtrace_607.cactuBSSN_s-2421B.champsimtrace_619.lbm_s-4268B.champsimtrace_638.imagick_s-10316B.champsimtrace.txt,2763153001,0.07238,200000004,1309087,3182714,4491801,498414020,0.4013,200000004,954024,1631350,2585374,1402245801,0.1426,200000002,7087665,9725200,16812865,257929163,0.7754,200000003,91472,86278,177750,1245833,337484,2574609,4335295,09 hr 05 min 38 sec
605.mcf_s-665B.champsimtrace_607.cactuBSSN_s-2421B.champsimtrace_619.lbm_s-4268B.champsimtrace_648.exchange2_s-1699B.champsimtrace.txt,2694519567,0.07422,200000001,1414371,3021625,4435996,467956037,0.4274,200000000,1002965,1606010,2608975,1407268061,0.1421,200000000,7186859,9611682,16798541,140296069,1.426,200000000,0,8562,8562,783398,162663,2508858,4218117,11 hr 47 min 15 sec
607.cactuBSSN_s-2421B.champsimtrace_619.lbm_s-4268B.champsimtrace_638.imagick_s-10316B.champsimtrace_648.exchange2_s-1699B.champsimtrace.txt,440560084,0.454,200000004,973227,1594475,2567702,1358556714,0.1472,200000001,7197496,9632954,16830450,208386041,0.9598,200000001,5946,64263,70209,139818763,1.43,200000000,0,8444,8444,172806,118539,1264242,2108979,07 hr 29 min 03 sec
605.mcf_s-665B.champsimtrace_607.cactuBSSN_s-2421B.champsimtrace_619.lbm_s-4268B.champsimtrace_654.roms_s-842B.champsimtrace.txt,3205588394,0.06239,200000000,961292,3598284,4559576,505679582,0.3955,200000000,985783,1625198,2610981,1479922593,0.1351,200000000,7116045,9702426,16818471,198907685,1.005,200000002,54,34922,34976,1800374,313108,2989197,5073216,01 hr 13 min 24 sec
605.mcf_s-665B.champsimtrace_607.cactuBSSN_s-2421B.champsimtrace_625.x264_s-18B.champsimtrace_638.imagick_s-10316B.champsimtrace.txt,750025783,0.2667,200000000,2516488,1900581,4417069,195813848,1.021,200000004,1064326,1606631,2670957,95416690,2.096,200000002,146212,239813,386025,78361868,2.552,200000003,9,33237,33246,555894,27271,703695,1252080,03 hr 23 min 55 sec
605.mcf_s-665B.champsimtrace_607.cactuBSSN_s-2421B.champsimtrace_625.x264_s-18B.champsimtrace_648.exchange2_s-1699B.champsimtrace.txt,734281394,0.2724,200000002,2519269,1855870,4375139,190555742,1.05,200000004,1214716,1586212,2800928,93648873,2.136,200000000,145139,235719,380858,130955544,1.527,200000002,0,9735,9735,389604,11800,688318,1223252,02 hr 30 min 39 sec
605.mcf_s-665B.champsimtrace_607.cactuBSSN_s-2421B.champsimtrace_625.x264_s-18B.champsimtrace_654.roms_s-842B.champsimtrace.txt,927372357,0.2157,200000000,2356696,2058239,4414935,192376583,1.04,200000004,1072848,1592916,2665764,94754728,2.111,200000002,147900,237635,385535,160667064,1.245,200000000,117,31305,31422,881984,38318,871049,1571172,13 hr 19 min 26 sec
605.mcf_s-665B.champsimtrace_607.cactuBSSN_s-2421B.champsimtrace_638.imagick_s-10316B.champsimtrace_648.exchange2_s-1699B.champsimtrace.txt,655136049,0.3053,200000000,2587498,1790181,4377679,172005513,1.163,200000004,1136969,1594798,2731767,73574457,2.718,200000000,18917,29097,48014,129163131,1.548,200000000,0,8583,8583,201063,14110,612303,1055791,23 hr 02 min 11 sec
605.mcf_s-665B.champsimtrace_607.cactuBSSN_s-2421B.champsimtrace_638.imagick_s-10316B.champsimtrace_654.roms_s-842B.champsimtrace.txt,804162611,0.2487,200000003,2465829,1947110,4412939,173765752,1.151,200000004,1198636,1601597,2800233,74064204,2.7,200000000,152,30050,30202,157989153,1.266,200000004,317,31330,31647,544800,35059,753947,1336214,03 hr 53 min 04 sec
605.mcf_s-665B.champsimtrace_607.cactuBSSN_s-2421B.champsimtrace_648.exchange2_s-1699B.champsimtrace_654.roms_s-842B.champsimtrace.txt,792350013,0.2524,200000001,2510915,1907622,4418537,170601443,1.172,200000004,1138700,1584359,2723059,129810256,1.541,200000002,0,9073,9073,157598934,1.269,200000001,154,30386,30540,394919,16831,741883,1309952,02 hr 38 min 58 sec
605.mcf_s-665B.champsimtrace_619.lbm_s-4268B.champsimtrace_625.x264_s-18B.champsimtrace_638.imagick_s-10316B.champsimtrace.txt,1952945673,0.1024,200000000,2012397,2494581,4506978,1071933176,0.1866,200000001,7060309,9749538,16809847,176636264,1.132,200000001,159955,294710,454665,156698401,1.276,200000003,7751,55102,62853,1369689,347595,1835101,3085456,11 hr 08 min 13 sec
605.mcf_s-665B.champsimtrace_619.lbm_s-4268B.champsimtrace_625.x264_s-18B.champsimtrace_654.roms_s-842B.champsimtrace.txt,2249077720,0.08893,200000002,1698503,2761593,4460096,1153184241,0.1734,200000002,7073151,9731708,16804859,169614173,1.179,200000002,158822,285145,443967,189394048,1.056,200000001,66,34878,34944,1928110,349040,2110187,3576513,20 hr 03 min 26 sec
605.mcf_s-665B.champsimtrace_619.lbm_s-4268B.champsimtrace_638.imagick_s-10316B.champsimtrace_648.exchange2_s-1699B.champsimtrace.txt,1700307348,0.1176,200000000,2179451,2247033,4426484,988145448,0.2024,200000000,7097687,9684147,16781834,133112954,1.502,200000001,3337,46172,49509,134975145,1.482,200000001,0,8621,8621,464011,245290,1598886,2669717,05 hr 11 min 16 sec
605.mcf_s-665B.champsimtrace_619.lbm_s-4268B.champsimtrace_638.imagick_s-10316B.champsimtrace_654.roms_s-842B.champsimtrace.txt,2037739149,0.09815,200000004,1882482,2574755,4457237,1082088789,0.1848,200000002,7036323,9764700,16801023,138596642,1.443,200000004,35132,49155,84287,183648759,1.089,200000003,210,34927,35137,1203582,382031,1911831,3226079,11 hr 44 min 47 sec
605.mcf_s-665B.champsimtrace_619.lbm_s-4268B.champsimtrace_648.exchange2_s-1699B.champsimtrace_654.roms_s-842B.champsimtrace.txt,1935096699,0.1034,200000004,1956983,2460125,4417108,1068024218,0.1873,200000000,7116003,9676021,16792024,135105995,1.48,200000002,0,8665,8665,181169309,1.104,200000000,9,33469,33478,910031,251474,1815650,3056614,18 hr 32 min 51 sec
605.mcf_s-665B.champsimtrace_625.x264_s-18B.champsimtrace_638.imagick_s-10316B.champsimtrace_654.roms_s-842B.champsimtrace.txt,433825589,0.461,200000000,2842899,1615934,4458833,68572980,2.917,200000000,141012,206322,347334,52831095,3.786,200000000,3611,14656,18267,148029422,1.351,200000001,230,31352,31582,291856,18626,399488,609848,15 hr 01 min 37 sec
605.mcf_s-665B.champsimtrace_625.x264_s-18B.champsimtrace_638.imagick_s-10316B.champsimtrace_648.exchange2_s-1699B.champsimtrace.txt,355144829,0.5632,200000000,2885922,1536208,4422130,68640659,2.914,200000003,141186,210737,351923,52858692,3.784,200000004,79545,14929,94474,124749506,1.603,200000000,0,7705,7705,198894,10059,322962,439031,10 hr 31 min 36 sec
605.mcf_s-665B.champsimtrace_625.x264_s-18B.champsimtrace_648.exchange2_s-1699B.champsimtrace_654.roms_s-842B.champsimtrace.txt,422701924,0.4731,200000000,2843791,1578254,4422045,68162403,2.934,200000000,142882,204530,347412,125124815,1.598,200000000,0,7485,7485,147878697,1.352,200000004,116,30383,30499,236209,10101,389055,587433,13 hr 59 min 03 sec
605.mcf_s-665B.champsimtrace_638.imagick_s-10316B.champsimtrace_648.exchange2_s-1699B.champsimtrace_654.roms_s-842B.champsimtrace.txt,351379384,0.5692,200000000,2878797,1502052,4380849,52467743,3.812,200000002,2,13371,13373,124446654,1.607,200000001,0,6446,6446,146624178,1.364,200000004,345,32841,33186,171552,8250,318383,439444,12 hr 04 min 21 sec
607.cactuBSSN_s-2421B.champsimtrace_619.lbm_s-4268B.champsimtrace_625.x264_s-18B.champsimtrace_638.imagick_s-10316B.champsimtrace.txt,505572305,0.3956,200000000,992190,1622687,2614877,1412142782,0.1416,200000002,7107219,9710044,16817263,220663132,0.9064,200000002,146182,302778,448960,262863169,0.7609,200000001,53683,86573,140256,703937,177249,1314126,2202529,12 hr 01 min 19 sec
607.cactuBSSN_s-2421B.champsimtrace_619.lbm_s-4268B.champsimtrace_625.x264_s-18B.champsimtrace_648.exchange2_s-1699B.champsimtrace.txt,470970116,0.4247,200000001,964952,1597066,2562018,1420465994,0.1408,200000000,7209656,9600458,16810114,211021367,0.9478,200000002,151208,291239,442447,139818407,1.43,200000000,0,8391,8391,508272,91527,1320792,2212635,11 hr 51 min 20 sec
607.cactuBSSN_s-2421B.champsimtrace_619.lbm_s-4268B.champsimtrace_625.x264_s-18B.champsimtrace_654.roms_s-842B.champsimtrace.txt,523453413,0.3821,200000000,1053526,1625571,2679097,1482360183,0.1349,200000000,7137977,9692170,16830147,209373772,0.9552,200000000,155413,287422,442835,198104663,1.01,200000002,30,33107,33137,881451,167192,1380455,2327571,11 hr 13 min 26 sec
607.cactuBSSN_s-2421B.champsimtrace_619.lbm_s-4268B.champsimtrace_648.exchange2_s-1699B.champsimtrace_654.roms_s-842B.champsimtrace.txt,449485136,0.445,200000002,987823,1592767,2580590,1426488220,0.1402,200000002,7212892,9624305,16837197,139881688,1.43,200000001,0,8449,8449,193821801,1.032,200000004,101,31906,32007,362777,110706,1327499,2224799,09 hr 40 min 53 sec
607.cactuBSSN_s-2421B.champsimtrace_619.lbm_s-4268B.champsimtrace_638.imagick_s-10316B.champsimtrace_654.roms_s-842B.champsimtrace.txt,491219758,0.4071,200000000,1096338,1620718,2717056,1417196316,0.1411,200000000,7131267,9715630,16846897,208896316,0.9574,200000002,9742,65702,75444,195408579,1.023,200000004,127,33729,33856,521265,185832,1318359,2216221,15 hr 00 min 42 sec
607.cactuBSSN_s-2421B.champsimtrace_625.x264_s-18B.champsimtrace_638.imagick_s-10316B.champsimtrace_648.exchange2_s-1699B.champsimtrace.txt,177876152,1.124,200000002,1185644,1604787,2790431,87310598,2.291,200000000,153638,227673,381311,71452404,2.799,200000001,0,27284,27284,129080423,1.549,200000001,0,8765,8765,92871,5164,166040,287696,21 hr 51 min 30 sec
607.cactuBSSN_s-2421B.champsimtrace_625.x264_s-18B.champsimtrace_638.imagick_s-10316B.champsimtrace_654.roms_s-842B.champsimtrace.txt,180121498,1.11,200000003,1087637,1616433,2704070,87514837,2.285,200000001,153693,230583,384276,71714401,2.789,200000003,23,27986,28009,158697729,1.26,200000000,20,32445,32465,116384,6664,168365,291949,22 hr 00 min 29 sec
607.cactuBSSN_s-2421B.champsimtrace_625.x264_s-18B.champsimtrace_648.exchange2_s-1699B.champsimtrace_654.roms_s-842B.champsimtrace.txt,174590785,1.146,200000003,1241620,1589513,2831133,85978085,2.326,200000002,156789,223816,380605,129387795,1.546,200000000,0,8747,8747,158492717,1.262,200000002,95,31346,31441,69838,2935,163201,283267,20 hr 09 min 51 sec
607.cactuBSSN_s-2421B.champsimtrace_638.imagick_s-10316B.champsimtrace_648.exchange2_s-1699B.champsimtrace_654.roms_s-842B.champsimtrace.txt,161229417,1.24,200000002,1127255,1611043,2738298,68472414,2.921,200000000,6846,24504,31350,128273980,1.559,200000001,0,8330,8330,155822405,1.284,200000000,40,33258,33298,68994,3358,149163,242092,21 hr 12 min 27 sec
619.lbm_s-4268B.champsimtrace_625.x264_s-18B.champsimtrace_638.imagick_s-10316B.champsimtrace_648.exchange2_s-1699B.champsimtrace.txt,995325399,0.2009,200000000,7133410,9693996,16827406,153787201,1.3,200000004,169358,266138,435496,131007396,1.527,200000000,0,43154,43154,136083699,1.47,200000000,0,9134,9134,430290,158292,931656,1552568,18 hr 39 min 32 sec
619.lbm_s-4268B.champsimtrace_625.x264_s-18B.champsimtrace_638.imagick_s-10316B.champsimtrace_654.roms_s-842B.champsimtrace.txt,1092744001,0.183,200000000,7054240,9775325,16829565,161872786,1.236,200000001,164416,281916,446332,141588381,1.413,200000000,54896,49214,104110,184813440,1.082,200000004,12,33983,33995,815820,225281,1023679,1716830,17 hr 42 min 25 sec
619.lbm_s-4268B.champsimtrace_625.x264_s-18B.champsimtrace_648.exchange2_s-1699B.champsimtrace_654.roms_s-842B.champsimtrace.txt,1076750132,0.1857,200000000,7136067,9681825,16817892,152311836,1.313,200000001,170702,266859,437561,135236039,1.479,200000001,0,8043,8043,182120928,1.098,200000000,103,32648,32751,634077,153409,1009222,1692566,19 hr 40 min 27 sec
619.lbm_s-4268B.champsimtrace_638.imagick_s-10316B.champsimtrace_648.exchange2_s-1699B.champsimtrace_654.roms_s-842B.champsimtrace.txt,1003763844,0.1993,200000002,7011504,9816113,16827617,124614607,1.605,200000002,177522,43918,221440,134375015,1.488,200000004,0,8509,8509,179439828,1.115,200000000,92,34004,34096,548454,224576,942367,1562646,12 hr 36 min 11 sec
625.x264_s-18B.champsimtrace_638.imagick_s-10316B.champsimtrace_648.exchange2_s-1699B.champsimtrace_654.roms_s-842B.champsimtrace.txt,68221090,2.932,200000003,121685,190846,312531,52110377,3.838,200000002,65,10744,10809,124821153,1.602,200000000,0,6405,6405,147416607,1.357,200000002,3118,33952,37070,38516,1331,120053,148879,00 hr 53 min 46 sec
